project:
  type: book
  output-dir: "book"
biblio-title: References
bibliography: cites.bib
biblio-style: mla
link-citations: true
nocite: '@*'
csl: modern-language-association.csl
pdf-cover: "images/cover.png"
pdf-logo: "images/app-logo.png"
pdf-cover-author-color: "0, 0, 0"
pdf-cover-font-color: "255, 255, 255"
pdf-cover-color: "111, 144, 132"
book:
  title: "${cuneiform_DESCRIPTION} ${FULL_DISPLAY_VERSION}"
  subtitle: "User Manual"
  description: "${PROGRAM_COMMENTS}"
  author: "${PROGRAM_AUTHOR}"
  date: today
  date-format: "YYYY"
  output-file: "cuneiform"
  language: en
  chapters:
    - index.qmd
    - building.qmd
    - part: "Command-line Utility"
      chapters:
      - command-line/options.qmd
      - command-line/examples.qmd
      - command-line/reviewing-output.qmd
    - part: "User Interface"
      chapters:
      - gui/new-project.qmd
      - gui/reviewing-output.qmd
      - gui/editing.qmd
      - gui/tools.qmd
      - gui/options.qmd
    - part: "Additional Features"
      chapters:
      - suppression.qmd
  appendices:
    - acknowledgements.qmd
format:
  pdf:
    documentclass: book
    template: latex/default.tex
    include-in-header: latex/preamble.tex
    latex-engine: xelatex
    keep-tex: true
    citation-package: biblatex
    cite-method: biblatex
    lot: false
    code-block-bg: false
